2,3,3,7,2,30,47,7
10,11,11,15,10,38,55,15
4,19,20,6,4,19,20,23
12,51,52,14,12,53,54,23
20,21,9,22,20,61,62,35
1,9,1,1,1,22,20,43
26,5,1,28,26,53,54,23
24,25,25,29,24,25,25,29
